"Full Factor","90%","80%","70%","60%","50%","40%","30%","20%","10%"
"1","0","0","0","0","1","1","1","1","1"
"2","0","0","1","1","1","1","1","2","2"
"3","0","1","1","1","2","2","2","2","3"
"5","1","1","2","2","3","3","4","4","5"
"10","1","2","3","4","5","6","7","8","9"
"12","1","2","4","5","6","7","8","10","11"
"15","2","3","5","6","8","9","11","12","14"
"20","2","4","6","8","10","12","14","16","18"
"30","3","6","9","12","145","18","21","24","27"
"50","5","10","15","20","25","30","35","40","45"
"100","10","20","30","40","50","60","70","80","90"
"120","12","24","36","48","60","72","84","96","108"
"150","15","30","45","60","75","90","105","120","135"
"200","20","40","60","80","100","120","140","160","180"
"300","30","60","90","120","150","180","210","240","270"
"500","50","100","150","200","250","300","350","400","450"
"1000","100","200","300","400","500","600","700","800","900"
"1200","120","240","360","480","600","720","840","960","1080"
"1500","150","300","450","600","750","900","1050","1200","1350"
"2000","200","400","600","800","1000","1200","1400","1600","1800"
"3000","300","600","900","1200","1500","1800","2100","2400","2700"
"5000","500","1000","1500","2000","2500","300","3500","4000","4500"
"20000","2000","4000","6000","8000","10000","1200","14000","16000","18000"
"150000","15000","30000","45000","60000","75000","9000","105000","120000","135000"
